{
	"name":"level 1 - snowy snow",
	"map": [
		[87, 81, 81, 81, 81, 81, 81, 81, 81, 81, 85],
		[82, 75, 73, 76, 73, 72, 73, 75, 79, 75, 80],
		[82, 92, 95, 72, 78, 95, 76, 72, 79, 72, 80],
		[82, 75, 73, 76, 72, 94, 72, 75, 74, 79, 80],
		[82, 73, 72, 72, 73, 92, 73, 77, 76, 76, 80],
		[82, 79, 74, 75, 92, 72, 72, 72, 75, 72, 80],
		[82, 72, 76, 78, 74, 73, 73, 73, 72, 73, 80],
		[82, 95, 74, 72, 75, 95, 72, 74, 75, 92, 80],
		[82, 72, 93, 93, 76, 72, 76, 72, 93, 72, 80],
		[82, 73, 74, 75, 74, 93, 78, 95, 94, 75, 80],
		[84, 83, 83, 83, 83, 83, 83, 83, 83, 83, 86]
	],
	"objects": [{
		"x": 9,
		"y": 1,
		"type": "sawblade"
	},
	{
		"x": 1,
		"y": 1,
		"type": "barrel"
	},
	{
		"x": 1,
		"y": 9,
		"type": "barrel"
	},
	{
		"x": 5,
		"y": 5,
		"type": "enemyspawner"
	},
	{
		"x": 9,
		"y": 2,
		"type": "enemyspawner"
	}],
	"properties":{
		"spawn": {
			"x": 9,
			"y": 9
		},
		"spawncount":12,
		"spawnrate":4
	}
}